#######################
#S                    E#
#                      #
#                      #
#######################
