######
#S   #
# #E #
#    #
######
