#####
#S  E#
## ###
#    #
#####