########
#S  #   #
# ### #E#
#       #
########